NO path_to_north
SO path_to_south


WE path_to_west




EA path_to_east



11111111111111 
1000010001     
1000010001     
1000110001 1111
1000100001 1001
1000000001 1111
100000000111
100000000001
1000000N011
1111111111