11111111111111
1000010001
1000010001 
1000110001
1000100001
1000000001
1000000001
1000000011
1000000N011 N
1111111111