NO texture_examples/redbrick.png
WE texture_examples/purplestone.png
EA texture_examples/purplestone.png
SO texture_examples/redbrick.png
F 0,0,255
C 239,230,90

1111111111
1000000001
10E0000111
1000110111
1000010111
1000000011
1111111111
