NO texture_examples/hoofd1.png
WE texture_examples/bw_splash.png
EA texture_examples/bw_splash.png
SO texture_examples/bw_splash.png
F texture_examples/hoofd2.png
C 0,0,0

D texture_examples/wood.png
SP texture_examples/pillar.png 4.5 2.5
SP texture_examples/barrel.png 5.5 3.5
SP texture_examples/sexy.png 9.5 3.5
SP texture_examples/hoofd.png 8.5 2.5

11111111111111
10000100011111
1000010001
100001D111 
111100001
1001000001111111
100D000N000000D1
1001000000011111
11110000011
1111111111
