NO texture_examples/redbrick.png
WE texture_examples/purplestone.png
EA texture_examples/purplestone.png
SO texture_examples/redbrick.png

fweoiuf
wef   wefwefwefwefwef wefew

F 255,0,0
C 255,0,0

11111
10001
10E01
10001
11111
