NO  path_to_north
WE  path_to_west
EA  path_to_east
SO	path_to_south
F	123,234,213
C	12,34,3
111111
100001
10N001
100001
111111
