NO  path_to_north
WE  path_to_west
EA  path_to_east
SO	path_to_south
F	123,234,213
C	12,34,3
11111
10001
10N01
10001
11111
