
NO texture_examples/purplestone1.png
WE texture_examples/redbrick.png
EA texture_examples/redbrick.png
SO texture_examples/purplestone2.png
F 255,0,0
C 12,34,3

111111
100001
100W01
100001
111111
