
NO texture_examples/purplestone1.png
WE texture_examples/redbrick.png
EA texture_examples/redbrick.png
SO texture_examples/purplestone2.png
F 255,0,0
C	12, 34,3

11111
1W011
11111
