NO texture_examples/purplestone1.png
WE texture_examples/redbrick.png
EA texture_examples/redbrick.png
SO texture_examples/purplestone2.xpm
F 00,153,15
C 255,255,255

1111111111111111111111111
1000000000000000000000001
1100000000000000000000001
100000000000000000000000111111111
111111111000000000000000000000001
100000000000000000000000000001111
10000000000000E10000000000001
10000000000000000000000000001
10000000000000000000000000001
10000000000000000000000000001
10000000000000000001010000001
11000001111111111111111111111
11110111 1111111 11111111111
11111111 1111111 111111111111
