NO texture_examples/purplestone1.png
WE texture_examples/redbrick.png
EA texture_examples/redbrick.png
SO texture_examples/purplestone2.png
C 0,0,0
F 255,0,0

11111111111111 
1000010001 
1000010001 
1000110000000
1000100001 
1000000001 
100000000111
100000000001
1000000N011
1111111111 