NO texture_examples/purplestone1.png
WE texture_examples/redbrick.png
EA texture_examples/redbrick.png
SO texture_examples/purplestone2.png
F 100,       100, 			100
C_ALT texture_examples/ceiling_square.png
C 255,255,255

11111
10N01
11111
