NO  path_to_north
WE  path_to_west
EA  path_to_east
SO	path_to_south
F	255,89,89
C	12, 34,3

11111111111111 
1000010001     
1000010001     
1000110001 
1000100001 
1000000001 
100000000111
100000000001
1000000N011
1111111111 
