NO  texture_examples/purplestone1.png
WE  texture_examples/redbrick.png
EA  texture_examples/redbrick.png
SO	texture_examples/purplestone2.png
F	texture_examples/floor.png
C	texture_examples/ceiling_square.png

11111111111111 
1000010001 
1000N10001 
1000000001 
1000000001 
1000000001 
111000000111
100000100001
10000000011
1111111111 
