NO texture_examples/purplestone1.png
WE texture_examples/redbrick.png
EA texture_examples/redbrick.png
SO texture_examples/purplestone2.png
F texture_examples/floor.png
C texture_examples/ceiling_square.png

SP texture_examples/pillar.png 4.5 2.5
SP texture_examples/barrel.png 5.5 3.5
DR texture_examples/wood.png

11111111111111
1000000001
1000000001
1000000001
10000000D1
100000000111
111000N00111
100000000001
10000000011
1111111111 
