NO  texture_examples/purplestone1.png
WE  texture_examples/redbrick.png
EA  texture_examples/redbrick.png
SO	texture_examples/purplestone1.png
F	255,255,255
C	12, 12, 12

11111111111111 
1000000001 
1000N00001 
1000000001 
1000000001 
1000000001 
100000000111
100000000001
10000000011
1111111111 
